111111111111111111111
1000C000C000000000001
100E000000001000C0001
100000000C00111000001
1000P0000010111110001
100000000000001111111
10000000C000000000001
10000000000000001C001
100000000C11111110001
100000000010000010001
100C00000000000011111
111100111111111111111
1000C000C000000000001
1000000000001000C0001
111111111111111111111
